11111111111111111111
1010C00100C0CP00C001
10VC000E10000100C001
100100V01VVV00CCC001
10000C000C000100C001
10VV01010C000000C001
11111111111111111111